BBBBBBBBBBBBBBBBBBBBBBBBBBBBBBBBBBBBBBBBBBBBBBBBBBBBBBBBBBBBBBBB
GFFFFFFFFFFFFFFFFFFFFFFFFFFFFFFFFFFFFFFFFFFFFFFFFFFFFFFFFFFFFFFG
GFFFFFFFFFFFFFFFFFFFFFFFFFFFFFFFFFFFFFFFFFFFFFFFFFFFFFFFFFFFFFFG
GFFFFFFFFFFFFFFFFFFFFFFFFFFFFFFFFFFFFFFFFFFFFFFFFFFFFFFFFFFFFFFG
GFFFFFFFFFFFFFFFFFFFFFFFFFFFFFFFFFFFFFFFFFFFFFFFFFFFFFFFFFFFFFFG
GFFFFFFFFFFFFFFFFFFFFFFFFFFFFFFFFFFFFFFFFFFFFFFFFFFFFFFFFFFFFFFG
GFFFFFFFFFFFFFFFFFFFFFFFFFFFFFFFFFFFFFFFFFFFFFFFFFFFFFFFFFFFFFFG
GFFFFFFFFFFFFFFFFFFFFFFFFFFFFFFFFFFFFFFFFFFFFFFFFFFFFFFFFFFFFFFG
GFFFFFFFFFFFFFFFFFFFFFFFFFFFFFFFFFFFFFFFFFFFFFFFFFFFFFFFFFFFFFFG
GFFFFFFFFFFFFFFFFFFFFFFFFFFFFFFFFFFFFFFFFFFFFFFFFFFFFFFFFFFFFFFG
GFFFFFFFFFFFFFFFFFFFFFFFFFFFFFFFFFFFFFFFFFFFFFFFFFFFFFFFFFFFFFFG
GFFFFFFFFFFFFFFFFFFFFFFFFFFFFFFFFFFFFFFFFFFFFFFFFFFFFFFFFFFFFFFG
GFFFFFFFFFFFFFFFFFFFFFFFFFFFFFFFFFFFFFFFFFFFFFFFFFFFFFFFFFFFFFFG
GFFFFFFFFFFFFFFFFFFFFFFFFFFFFFFFFFFFFFFFFFFFFFFFFFFFFFFFFFFFFFFG
GFFFFFFFFFFFFFFFFFFFFFFFFFFFFFFFFFFFFFFFFFFFFFFFFFFFFFFFFFFFFFFG
GFFFFFFFFFFFFFFFFFFFFFFFFFFFFFFFFFFFFFFFFFFFFFFFFFFFFFFFFFFFFFFG
GFFFFFFFFFFFFFFFFFFFFFFFFFFFFFFFFFFFFFFFFFFFFFFFFFFFFFFFFFFFFFFG
GFFFFFFFFFFFFFFFFFFFFFFFFFFFFFFFFFFFFFFFFFFFFFFFFFFFFFFFFFFFFFFG
GFFFFFFFFFFFFFFFFFFFFFFFFFFFFFFFFFFFFFFFFFFFFFFFFFFFFFFFFFFFFFFG
GFFFFFFFFFFFFFFFFFFFFFFFFFFFFFFFFFFFFFFFFFFFFFFFFFFFFFFFFFFFFFFG
GFFFFFFFFFFFFFFFFFFFFFFFFFFFFFFFFFFFFFFFFFFFFFFFFFFFFFFFFFFFFFFG
GFFFFFFFFFFFFFFFFFFFFFFFFFFFFFFFFFFFFFFFFFFFFFFFFFFFFFFFFFFFFFFG
GFFFFFFFFFFFFFFFFFFFFFFFFFFFFFFFFFFFFFFFFFFFFFFFFFFFFFFFFFFFFFFG
GFFFFFFFFFFFFFFFFFFFFFFFFFFFFFFFFFFFFFFFFFFFFFFFFFFFFFFFFFFFFFFG
GFFFFFFFFFFFFFFFFFFFFFFFFFFFFFFFFFFFFFFFFFFFFFFFFFFFFFFFFFFFFFFG
GFFFFFFFFFFFFFFFFFFFFFFFFFFFFFFFFFFFFFFFFFFFFFFFFFFFFFFFFFFFFFFG
GFFFFFFFFFFFFFFFFFFFFFFFFFFFFFFFFFFFFFFFFFFFFFFFFFFFFFFFFFFFFFFG
GFFFFFFFFFFFFFFFFFFFFFFFFFFFFFFFFFFFFFFFFFFFFFFFFFFFFFFFFFFFFFFG
GFFFFFFFFFFFFFFFFFFFFFFFFFFFFFFFFFFFFFFFFFFFFFFFFFFFFFFFFFFFFFFG
GFFFFFFFFFFFFFFFFFFFFFFFFFFFFFFFFFFFFFFFFFFFFFFFFFFFFFFFFFFFFFFG
GFFFFFFFFFFFFFFFFFFFFFFFFFFFFFFFFFFFFFFFFFFFFFFFFFFFFFFFFFFFFFFG
GFFFFFFFFFFFFFFFFFFFFFFFFFFFFFFFFFFFFFFFFFFFFFFFFFFFFFFFFFFFFFFG
GFFFFFFFFFFFFFFFFFFFFFFFFFFFFFFFFFFFFFFFFFFFFFFFFFFFFFFFFFFFFFFG
GFFFFFFFFFFFFFFFFFFFFFFFFFFFFFFFFFFFFFFFFFFFFFFFFFFFFFFFFFFFFFFG
GFFFFFFFFFFFFFFFFFFFFFFFFFFFFFFFFFFFFFFFFFFFFFFFFFFFFFFFFFFFFFFG
GFFFFFFFFFFFFFFFFFFFFFFFFFFFFFFFFFFFFFFFFFFFFFFFFFFFFFFFFFFFFFFG
GFFFFFFFFFFFFFFFFFFFFFFFFFFFFFFFFFFFFFFFFFFFFFFFFFFFFFFFFFFFFFFG
GFFFFFFFFFFFFFFFFFFFFFFFFFFFFFFFFFFFFFFFFFFFFFFFFFFFFFFFFFFFFFFG
GFFFFFFFFFFFFFFFFFFFFFFFFFFFFFFFFFFFFFFFFFFFFFFFFFFFFFFFFFFFFFFG
GFFFFFFFFFFFFFFFFFFFFBBBBBBBBBBBBBBBBBBBBBBFFFFFFFFFFFFFFFFFFFFG
GFFFFFFFFFFFFFFFFFFFFGFFFFFFFFFFFFFFFFFFFFGFFFFFFFFFFFFFFFFFFFFG
GFFFFFFFFFFFFFFFFFFFFGFFFFFFFFFFFFFFFFFFFFGFFFFFFFFFFFFFFFFFFFFG
GFFFFFFFFFFFFFFFFFFFFGFFFFFFFFFFFFFFFFFFFFGFFFFFFFFFFFFFFFFFFFFG
GFFFFFFFFFFFFFFFFFFFFGFFFFFFFFFFFFFFFFFFFFGFFFFFFFFFFFFFFFFFFFFG
GFFFFFFFFFFFFFFFFFFFFGFFFFFFFFFFFFFFFFFFFFGFFFFFFFFFFFFFFFFFFFFG
GFFFFFFFFFFFFFFFFFFFFGFFFFFFFFFFFFFFFFFFFFGFFFFFFFFFFFFFFFFFFFFG
GFFFFFFFFFFFFFFFFFFFFGFFFFFFFFFFFFFFFFFFFFGFFFFFFFFFFFFFFFFFFFFG
GFFFFFFFFFFFFFFFFFFFFGFFFFFFFFFFFFFFFFFFFFGFFFFFFFFFFFFFFFFFFFFG
GFFFFFFFFFFFFFFFFFFFFGFFFFFFFFFFFFFFFFFFFFGFFFFFFFFFFFFFFFFFFFFG
GFFFFFFFFFFFFFFFFFFFFGFFFFFFFFFFFFFFFFFFFFGFFFFFFFFFFFFFFFFFFFFG
GFFFFFFFFFFFFFFFFFFFFGFFFFFFFFFFFFFFFFFFFFGFFFFFFFFFFFFFFFFFFFFG
GFFFFFFFFFFFFFFFFFFFFGFFFFFFFFFFFFFFFFFFFFGFFFFFFFFFFFFFFFFFFFFG
GFFFFFFFFFFFFFFFFFFFFGFFFFFFFFFFFFFFFFFFFFGFFFFFFFFFFFFFFFFFFFFG
GFFFFFFFFFFFFFFFFFFFFGFFFFFFFFFFFFFFFFFFFFGFFFFFFFFFFFFFFFFFFFFG
GFFFFFFFFFFFFFFFFFFFFGFFFFFFFFFFFFFFFFFFFFGFFFFFFFFFFFFFFFFFFFFG
GFFFFFFFFFFFFFFFFFFFFGFFFFFFFFFFFFFFFFFFFFGFFFFFFFFFFFFFFFFFFFFG
GFFFFFFFFFFFFFFFFFFFFGFFFFFFFFFFFFFFFFFFFFGFFFFFFFFFFFFFFFFFFFFG
GFFFFFFFFFFFFFFFFFFFFGFFFFFFFFFFFFFFFFFFFFGFFFFFFFFFFFFFFFFFFFFG
GFFFFFFFFFFFFFFFFFFFFGFFFFFFFFFFFFFFFFFFFFGFFFFFFFFFFFFFFFFFFFFG
GFFFFFFFFFFFFFFFFFFFFGFFFFFFFFFFFFFFFFFFFFGFFFFFFFFFFFFFFFFFFFFG
GFFFFFFFFFFFFFFFFFFFFGFFFFFFFFFFFFFFFFFFFFGFFFFFFFFFFFFFFFFFFFFG
GFFFFFFFFFFFFFFFFFFFFGFFFFFFFFFFFFFFFFFFFFGFFFFFFFFFFFFFFFFFFFFG
GFFFFFFFFFFFFFFFFFFFFGFFFFFFFFFFFFFFFFFFFFGFFFFFFFFFFFFFFFFFFFFG
BBBBBBBBBBBBBBBBBBBBBBBBBBBBBBBBBBBBBBBBBBBBBBBBBBBBBBBBBBBBBBBB

